You wake up tired and groggy in the middle of a forest. You sleepily scan your surroundings and notice that they are unfamiliar and you have no idea how you got here. You try hard to remember how you got here, but you just can't seem to find the memory. In fact, you can't find any of your memories…

You snatch your backpack up off the ground, sling it over your shoulders, and start your quest to explore the island in hope of discovering who you are, how you got here, and how you're going to get home.

Escape From Paradise
An Interactive Fiction by Nik Hager
Release 1 / Serial number 131007 / Inform 7 build 6G60 (I6/v6.32 lib 6/12N) SD

Camp
The camp is set up in a small clearing between four huge canopy trees for shade and shelter from rain. You notice there is a fire pit in the middle that you must have build before, but the fire has burnt out leaving a mound of ash surrounded by charred rocks.

You can see a knife, a coil of rope, and a bottle (empty) here.

I beg your pardon?

>n
Southern Forest
Huge trees and bushes surround you as far as you can see.

>n
You journey deeper into the forest. 
Central Forest
The jungle is all you can see.

You can see a strange rock here.

>n
Northern Forest
You walk out of the trees and into a small clearing. There is a large rock here with strange engravings on it.

>n
Mountain Base

>n
Mountain Summit Shrine
You walk up the long winding mountain path until you reach the summit. There is a shrine here for one of the island's gods. A man in shiny golden robes and a silver helmet is examining a massive golden door guarded by two black statues. The air coming from the door feels magical, almost like a divine being is on the other side.

He is muttering to himself, "Stupid door, why won't you open? The Shaman said to press the tiles so I pressed the tiles. You haven't been opened for hundreds of years! How are we supposed to commence all of our ceremonial rituals if we can't get into the shrine room!"

You can see a Chief and a golden door here.

>x wall
You can't see any such thing.

>talk to the chief
The man hears your footsteps and turns around red and irritated.

"I am Chief Radzen, leader of the Geracian tribe and this is my land. Who are you and what is your purpose for coming to me?" he says.

You explain your situation to the Chief while he nods understandingly.

"Mmmhmmm… I see… Well, you need to find a way to get home don't you? We could help you, but first you need to prove you are worthy of our assistance and that you aren't just someone from an enemy tribe trying to invade us. Hmmmm… there is a magical beast on the other side of the river to the east of our village. It has been terrorizing my people, eating our livestock and trampling our crops. Find the beast and kill him. Then come talk to me. I'll be in my hut; thinking of ways to open that stupid door…"

The Chief then walks briskly past you and dissapears down the mountain path.

>x wall
Upon further examination, there appears to be seven different colored tiles on the wall (blue, red, green, white, black, yellow, and brown). Maybe pressing them in a certain order will open the door.

>press white tile
Nothing obvious happens.

* * *

>x fireplace
You see nothing special about the fire pit.

>x room
You can't see any such thing.

>v
That's not a verb I recognise.

>b
That's not a verb I recognise.

>bn
That's not a verb I recognise.

>m
That's not a verb I recognise.

>c
That's not a verb I recognise.

>x
(the backpack)
The backpack is empty.

>z
Time passes.

>a
That's not a verb I recognise.

>s
Beach
You head south, weaving through the trees, watching the grassy terrain of the jungle slowly fade to dirt. Soon, the dirt is gone and you can see the ocean through the remainder of the trees. You burst through the gap out of  the foliage and into the light. The sand heats your toes and sends a warm surge throughout your body. The relaxing sun shines down onto the water, causing it to shimmer with brilliance.

>n
Camp
You are in a small clearing between four huge canopy trees. You notice you have built a fire pit, but the fire has burnt out leaving a mound of ash surrounded by rocks.

You can see a burnt wood, an ashes, a rocks, a knife, a coil of rope, and a bottle (empty) here.

* * *

>take knife
You pick up the knife and put it in the front pocket of your backpack.

>i
You are carrying:
  a backpack
    a knife

>take rope
You roll up the rope and put it into your backpack.

>i
You are carrying:
  a backpack
    a coil of rope
    a knife

>take bottle
You pick up the empty bottle and put it into your backpack.

>i
You are carrying:
  a backpack
    a bottle
    a coil of rope
    a knife

* * *

>i
You are carrying:
  a backpack holding

>take knife
You pick up the knife and put it in the front pocket of your backpack.

>i
You are carrying:
  a backpack holding
    a knife

* * *

>n
Southern Forest
Huge trees and bushes surround you as far as you can see.

>n
You journey deeper into the forest. 
Central Forest
The jungle is all you can see.

I beg your pardon?

I beg your pardon?

>n
Northern Forest
You walk out of the trees and into a small clearing. There is a large rock here with strange engravings on it.

* * *

>n
Mountain Base

>n
Mountain Summit Shrine
You walk up the long winding mountain path until you reach the summit. There is a shrine here for one of the island's gods. A man in shiny golden robes and a silver helmet is examining a massive golden door guarded by two black statues. The air coming from the door feels magical, almost like a divine being is on the other side.

He is muttering to himself, "Stupid door, why won't you open? The Shaman said to press the tiles so I pressed the tiles. You haven't been opened for hundreds of years! How are we supposed to commence all of our ceremonial rituals if we can't get into the shrine room!"

You can see a golden door and a Chief here.

>talk to the chief]
You can't see any such thing.

>talk to the chief
The man hears your footsteps and turns around red and irritated.

"I am Chief Radzen, leader of the Geracian tribe and this is my land. Who are you and what is your purpose for coming to me?" he says.

You explain your situation to the Chief while he nods understandingly.

"Mmmhmmm… I see… Well, you need to find a way to get home dontand't you? We could help you, but first you need to prove you are worthy of our assistance and that you aren't just someone from an enemy tribe trying to invade us. Hmmmm… there is a magical beast on the other side of the river to the east of our village. It has been terrorizing my people, eating our livestock and trampling our crops. Find the beast and kill him. Then come talk to me. I￿￿'ll be in my hut; thinking of ways to open that stupid door…re"

The Chief then walks briskly past you and dissapears down the mountain path.

>s
Mountain Base

>n
Mountain Summit Shrine
You walk up the long winding mountain path until you reach the summit. There is a shrine here for one of the island's gods. A man in shiny golden robes and a silver helmet is examining a massive golden door guarded by two black statues. The air coming from the door feels magical, almost like a divine being is on the other side.

He is muttering to himself, "Stupid door, why won't you open? The Shaman said to press the tiles so I pressed the tiles. You haven't been opened for hundreds of years! How are we supposed to commence all of our ceremonial rituals if we can't get into the shrine room!"

You can see a golden door and a wall (on which are a blue tile, a red tile, a green tile, a white tile, a black tile, a yellow tile, and a brown tile) here.

* * *

>n
You journey deeper into the forest. 
Central Forest
The jungle is all you can see.

>nn
That's not a verb I recognise.

>n
Northern Forest
You walk out of the trees and into a small clearing. There is a large rock here with strange engravings on it.

* * *

>n
(first opening the golden door)
It seems to be locked.

* * *

>n
You journey deeper into the forest. 
Central Forest
The jungle is all you can see.

>n
Northern Forest
You walk out of the trees and into a small clearing. There is a large rock here with strange engravings on it.

You can see a strange rock here.

>n
Mountain Base

>n
Mountain Summit Shrine
You walk up the long winding mountain path until you reach the summit. There is a shrine here for one of the island's gods. A man in shiny golden robes and a silver helmet is examining a massive golden door guarded by two black statues. The air coming from the door feels magical, almost like a divine being is on the other side.

He is muttering to himself, "Stupid door, why won't you open? The Shaman said to press the tiles so I pressed the tiles. You haven't been opened for hundreds of years! How are we supposed to commence all of our ceremonial rituals if we can't get into the shrine room!"

All the walls are gone now as well as the golden door. The hidden shrine room is to the east, beyond a shimmering veil of light.

You can see a Chief here.

>n
(first opening the golden door)
It seems to be locked.

>e
You can't go that way.

>x wall
You can't see any such thing.

* * *

>x wall
Upon further examination, there appears to be seven different colored tiles on the wall (blue, red, green, white, black, yellow, and brown). Maybe pressing them in a certain order will open the door.

>s
Mountain Base

>n
Mountain Summit Shrine
You walk up the long winding mountain path until you reach the summit. There is a shrine here for one of the island's gods. A man in shiny golden robes and a silver helmet is examining a massive golden door guarded by two black statues. The air coming from the door feels magical, almost like a divine being is on the other side.

He is muttering to himself, "Stupid door, why won't you open? The Shaman said to press the tiles so I pressed the tiles. You haven't been opened for hundreds of years! How are we supposed to commence all of our ceremonial rituals if we can't get into the shrine room!"

You can see a wall (on which are a brown tile, a yellow tile, a black tile, a white tile, a green tile, a red tile, and a blue tile) and a golden door here.

>e
You can't go that way.

>press white tile
Nothing obvious happens.

>press the white tile
Nothing obvious happens.

>press onto the white tile
You can't see any such thing.

>s
Mountain Base

>s
Northern Forest
You walk out of the trees and into a small clearing. There is a large rock here with strange engravings on it.

>s
Central Forest
The jungle is all you can see.

You can see a strange rock here.

>s
Southern Forest
Huge trees and bushes surround you as far as you can see.

>s
Camp
You are in a small clearing between four huge canopy trees. You notice you have built a fire pit, but the fire has burnt out leaving a mound of ash surrounded by rocks.

You can see a knife, a coil of rope, and a bottle (empty) here.

>take all
You know what they say. Don't cheat the game, cheat the player. I think that was the saying…

>n
Southern Forest
Huge trees and bushes surround you as far as you can see.

* * *

>n
Mountain Base

>n
Mountain Summit Shrine
You walk up the long winding mountain path until you reach the summit. There is a shrine here for one of the island's gods. A man in shiny golden robes and a silver helmet is examining a massive golden door guarded by two black statues. The air coming from the door feels magical, almost like a divine being is on the other side.

He is muttering to himself, "Stupid door, why won't you open? The Shaman said to press the tiles so I pressed the tiles. You haven't been opened for hundreds of years! How are we supposed to commence all of our ceremonial rituals if we can't get into the shrine room!"

You can see a wall (on which are a brown tile, a yellow tile, a black tile, a white tile, a green tile, a red tile, and a blue tile) and a golden door here.

>press white tile
Nothing obvious happens.

* * *

>n
(first opening the golden door)
It seems to be locked.

I beg your pardon?

>talk to chief
The man hears your footsteps and turns around red and irritated.

"I am Chief Radzen, leader of the Geracian tribe and this is my land. Who are you and what is your purpose for coming to me?" he says.

You explain your situation to the Chief while he nods understandingly.

"Mmmhmmm… I see… Well, you need to find a way to get home don't you? We could help you, but first you need to prove you are worthy of our assistance and that you aren't just someone from an enemy tribe trying to invade us. Hmmmm… there is a magical beast on the other side of the river to the east of our village. It has been terrorizing my people, eating our livestock and trampling our crops. Find the beast and kill him. Then come talk to me. I'll be in my hut; thinking of ways to open that stupid door…"

The Chief then walks briskly past you and dissapears down the mountain path.

>x wall
You examine the wall and see that there is an awkward stone jutting out of the wall that is slightly darker than the rest.

>s
Mountain Base

>n
Mountain Summit Shrine
You walk up the long winding mountain path until you reach the summit. There is a shrine here for one of the island's gods. A man in shiny golden robes and a silver helmet is examining a massive golden door guarded by two black statues. The air coming from the door feels magical, almost like a divine being is on the other side.

He is muttering to himself, "Stupid door, why won't you open? The Shaman said to press the tiles so I pressed the tiles. You haven't been opened for hundreds of years! How are we supposed to commence all of our ceremonial rituals if we can't get into the shrine room!"

You can see a wall and a golden door here.

>x wall
You see nothing special about the wall.

>x switch
You can't see any such thing.

>x stone
A protruding stone that is slightly darker than the rest. I wonder what would happen if you pressed it…

You press the stone into the wall with a loud "CLICK!". You hear the sound of old gears moving and watch as the wall shakes, and slowly parts, revealing a hidden room. This must be the shrine the Chief was looking for.

>press stone
You can't see any such thing.

>press dark stone
You can't see any such thing.

>take the stone
You can't see any such thing.

>press the stone
You can't see any such thing.

>e
Hidden Shrine Room
You walk in through the hidden entrance and burst into a shrine room for the island's main God. The room is amazing. Its gold, intricately engraved tiles on the floor and shimmering walls, giving off a faint flickering glow, made it hard to believe the room had been lost for centuries.

You can see a golden statue here.

>x hidden door
What are you looking for. You can't see a HIDDEN door. It's HIDDEN.

>talk to the statue
You speak to the statue, asking the god to help you return home. You wait a few seconds and when you are certain nothing is happening, you turn around and start to leave. Suddenly, you hear a loud "SNAP!" and you turn around to see an eyeglass at the base of the statue.

>take eyeglass
You pick the magic eyeglass up off the shimmering tiles and put it in the front pocket of your backpack.

>x eyeglass
A golden eyeglass giving off a soft magical hum. You might be able to use this to translate some kind of writing.

>w
Mountain Summit Shrine
You walk up the long winding mountain path until you reach the summit. There is a shrine here for one of the island's gods. A man in shiny golden robes and a silver helmet is examining a massive golden door guarded by two black statues. The air coming from the door feels magical, almost like a divine being is on the other side.

He is muttering to himself, "Stupid door, why won't you open? The Shaman said to press the tiles so I pressed the tiles. You haven't been opened for hundreds of years! How are we supposed to commence all of our ceremonial rituals if we can't get into the shrine room!"

You can see a golden door here.

>s
Mountain Base

>s
Northern Forest
You walk out of the trees and into a small clearing. There is a large rock here with strange engravings on it.

You can see a strange rock here.

>s
Central Forest
The jungle is all you can see.

>n
Northern Forest
You walk out of the trees and into a small clearing. There is a large rock here with strange engravings on it.

You can see a strange rock here.

>x rock
You examine the strange rock and see that it has strange engravings on it. You rub the engravings and the rock emanates a soft golden glow. When the light fades away, the rock is gone. In its place is a magical golden box radiating with a shimmering golden aura.

>x box
You take the eyeglass out the front pocket of your backpack and look through it, examining the engravings on the box. You watch as the symbols scatter around, rearranging themselves into letters and words you understand.
 It reads, "To get to the treasures lurking inside. Look to the sky. Let the skies be your guide."
 Hmmm. I wonder what that means.

>x rock
You can't see any such thing.

>i
You are carrying:
  a backpack
    a magic eyeglass

>x box
You take the eyeglass out the front pocket of your backpack and look through it, examining the engravings on the box. You watch as the symbols scatter around, rearranging themselves into letters and words you understand.
 It reads, "To get to the treasures lurking inside. Look to the sky. Let the skies be your guide."
 Hmmm. I wonder what that means.

>x sky
You look up at the sky and concentrate on the star constellations. A bright blue flash fills the sky energy and a bright blue line instantly forms in the sky, connecting the dots with the stars and forming words in the sky. "You already possess the key to success".

>x the sky
You look up at the sky and gaze at the stars. The beautiful constellations are extremely beautiful here as the sky is clean and clear.

>i
You are carrying:
  a backpack
    a magic key
    a magic eyeglass

>s
Central Forest
The jungle is all you can see.

>n
Northern Forest
You walk out of the trees and into a small clearing. There is a large rock here with strange engravings on it.

You can see a magical box (closed) here.

>open box
It seems to be locked.

>unlock the box
(with the backpack)
That doesn't seem to fit the lock.

>unlock the box with the magic key
(first taking the magic key)
You don't have anything to unlock the box with.

* * *

>n
(first opening the golden door)
It seems to be locked.

>talk to the chief
The man hears your footsteps and turns around red and irritated.

"I am Chief Radzen, leader of the Geracian tribe and this is my land. Who are you and what is your purpose for coming to me?" he says.

You explain your situation to the Chief while he nods understandingly.

"Mmmhmmm… I see… Well, you need to find a way to get home don't you? We could help you, but first you need to prove you are worthy of our assistance and that you aren't just someone from an enemy tribe trying to invade us. Hmmmm… there is a magical beast on the other side of the river to the east of our village. It has been terrorizing my people, eating our livestock and trampling our crops. Find the beast and kill him. Then come talk to me. I'll be in my hut; thinking of ways to open that stupid door…"

The Chief then walks briskly past you and dissapears down the mountain path.

>x wal
You can't see any such thing.

>x wall
Upon further examination, there appears to be seven different colored tiles on the wall (blue, red, green, white, black, yellow, and brown). Maybe pressing them in a certain order will open the door.

>press the white tile
Nothing obvious happens.

>x white tile
You see nothing special about the white tile.

* * *

>talk to chief
The man hears your footsteps and turns around red and irritated.

"I am Chief Radzen, leader of the Geracian tribe and this is my land. Who are you and what is your purpose for coming to me?" he says.

You explain your situation to the Chief while he nods understandingly.

"Mmmhmmm… I see… Well, you need to find a way to get home don't you? We could help you, but first you need to prove you are worthy of our assistance and that you aren't just someone from an enemy tribe trying to invade us. Hmmmm… there is a magical beast on the other side of the river to the east of our village. It has been terrorizing my people, eating our livestock and trampling our crops. Find the beast and kill him. Then come talk to me. I'll be in my hut; thinking of ways to open that stupid door…"

The Chief then walks briskly past you and dissapears down the mountain path.
Did you find a way to open that door? No? Well, then this is a waste of my time.

>open the door
Which do you mean, the hidden door or the golden door?

>x hidden door
What are you looking for. You can't see a HIDDEN door. It's HIDDEN.

>n
(first opening the golden door)
It seems to be locked.

>x door
Which do you mean, the hidden door or the golden door?

>x wall
You examine the wall and see that there is an awkward stone jutting out of the wall that is slightly darker than the rest.

>x stone
A protruding stone that is slightly darker than the rest. I wonder what would happen if you pressed it…

You press the stone into the wall with a loud "CLICK!". You hear the sound of old gears moving and watch as the wall shakes, and slowly parts, revealing a hidden room. This must be the shrine the Chief was looking for.

>push stone
You can't see any such thing.

>press stone
You can't see any such thing.

>e
Hidden Shrine Room
You walk in through the hidden entrance and burst into a shrine room for the island's main God. The room is amazing. Its gold, intricately engraved tiles on the floor and shimmering walls, giving off a faint flickering glow, made it hard to believe the room had been lost for centuries.

You can see a golden statue here.

>w
Mountain Summit Shrine
You walk up the long winding mountain path until you reach the summit. There is a shrine here for one of the island's gods. All the walls are gone now as well as the golden door. The hidden shrine room is to the east, beyond a shimmering veil of light.

>s
Mountain Base

* * *

>s
Central Forest
The jungle is all you can see.

>s
Southern Forest
Huge trees and bushes surround you as far as you can see.

>n
You journey deeper into the forest. 
Central Forest
The jungle is all you can see.

* * *

>x rock
You examine the strange rock and see that it has strange engravings on it. You rub the engravings and the rock emanates a soft golden glow. When the light fades away, the rock is gone. In its place is a magical golden box radiating with a shimmering golden aura.

>x box
A magical golden box radiating with a shimmering golden aura. It has the same strange engravings as the rock, but they are clearer now.

>n
Mountain Base

>n
Mountain Summit Shrine
You walk up the long winding mountain path until you reach the summit. There is a shrine here for one of the island's gods. All the walls are gone now as well as the golden door. The hidden shrine room is to the east, beyond a shimmering veil of light.

>n
(first opening the golden door)
It seems to be locked.

>e
Hidden Shrine Room
You walk in through the hidden entrance and burst into a shrine room for the island's main God. The room is amazing. Its gold, intricately engraved tiles on the floor and shimmering walls, giving off a faint flickering glow, made it hard to believe the room had been lost for centuries.

You can see a golden statue here.

>x statue
A statue of the island's main God, Master Tryn the King of Creation. It appears to have been hand carved with great skill from a single golden block of colossal proportions.

>talk to statue
You speak to the statue, asking the god to help you return home. You wait a few seconds and when you are certain nothing is happening, you turn around and start to leave. Suddenly, you hear a loud "SNAP!" and you turn around to see an eyeglass at the base of the statue.

>take eyeglass
You pick the magic eyeglass up off the shimmering tiles and put it in the front pocket of your backpack.

>s
You can't go that way.

>e
You can't go that way.

>w
Mountain Summit Shrine
You walk up the long winding mountain path until you reach the summit. There is a shrine here for one of the island's gods. All the walls are gone now as well as the golden door. The hidden shrine room is to the east, beyond a shimmering veil of light.

* * *

>s
Mountain Base

>s
Northern Forest
You walk out of the trees and into a small clearing. There is a large rock here with strange engravings on it.

You can see a magical box (in which are a blueprints and a map) here.

>s
Central Forest
The jungle is all you can see.

>n
Northern Forest
You walk out of the trees and into a small clearing. There is a large rock here with strange engravings on it.

You can see a magical box (in which are a blueprints and a map) here.

>x box
You take the eyeglass out the front pocket of your backpack and look through it, examining the engravings on the box. You watch as the symbols scatter around, rearranging themselves into letters and words you understand.

It reads, "To get to the treasures lurking inside. Look to the sky. Let the stars be your guide."

Hmmm. I wonder what that means.

>x sky
You look up at the sky and concentrate on the star constellations. A bright blue flash fills the sky energy and a bright blue line instantly forms in the sky, connecting the dots with the stars and forming words in the sky: "You already possess the key to success."

>i
You are carrying:
  a backpack
    a magic key
    a magic eyeglass

>open box
That's already open.

>unlock the box
(with the backpack)
That's unlocked at the moment.

>unlock the box with the magic key
(first taking the magic key)
That's unlocked at the moment.

>take eyeglass
You pick the magic eyeglass up off the shimmering tiles and put it in the front pocket of your backpack.

>n
Mountain Base

>s
Northern Forest
You walk out of the trees and into a small clearing. There is a large rock here with strange engravings on it.

You can see a magical box (in which are a blueprints and a map) here.

* * *

>s
Central Forest
The jungle is all you can see.

>w
Western Forest

>w
Village

>s
Chief's Hut
 

You can see a Chief and a Young Boy here.

>talk to the chief
What?!? You found the shrine room? It didn't even have anything to do with the golden door?!?!?!? Wow, what a waste of my time…

Thank you for finding the room. The shrine room has been lost for centuries. The greatest thanks from me and my people for helping us.

What? You need help? Talk to the statue of our God in the shrine room. He might be able to help you.

I'm going to go see the village Shaman to see if he can help you.

>talk to the boy
"If you're looking for daddy, he went to see the Shaman on the other side of our village."

>n
Village

>n
Shaman's Hut
The hut of the island Shaman. The walls are lined with strange, voodoo like objects.

You can see a Chief and a Shaman here.

* * *

>n
You journey deeper into the forest. 
Central Forest
The jungle is all you can see.

>x rock
Gosh Darnit

>x rock
You can't see any such thing.

>x box
You see nothing special about the magical box.

>open box
You open the magical box, revealing a blueprints and a map.

* * *

>x firepit
You see nothing special about the fire pit.

>n
Southern Forest
Huge trees and bushes surround you as far as you can see.

>s
Camp
You are in a small clearing between four huge canopy trees. You notice you have built a fire pit, but the fire has burnt out leaving a mound of ash surrounded by rocks.

You can see some burnt wood, some ashes, some rocks, a knife, a coil of rope, and a bottle (empty) here.

>take rocks
You pick up some of the rocks and put them into your backback. DANG! They're really heavy!

>i
You are carrying:
  a backpack
    some rocks

>n
Southern Forest
Huge trees and bushes surround you as far as you can see.

* * *

>n
You journey deeper into the forest. 
Central Forest
The jungle is all you can see.

>w
Western Forest

* * *

>w
Village

>n
Shaman's Hut
The hut of the island Shaman. The walls are lined with strange, voodoo like objects.

You can see a Shaman here.

>talk to shaman
That's not a verb I recognise.

>ask shaman about penis
There is no reply.

* * *

>s
Beach
You head south, weaving through the trees, watching the grassy terrain of the jungle slowly fade to dirt. Soon, the dirt is gone and you can see the ocean through the remainder of the trees. You burst through the gap out of  the foliage and into the light. The sand heats your toes and sends a warm surge throughout your body. The relaxing sun shines down onto the water, causing it to shimmer with brilliance.

You can see a boat and water (empty) here.

>n
Camp
You are in a small clearing between four huge canopy trees. You notice you have built a fire pit, but the fire has burnt out leaving a mound of ash surrounded by rocks.

You can see a knife, a coil of rope, and a bottle (empty) here.

>n
Southern Forest
Huge trees and bushes surround you as far as you can see.

* * *

>n
You journey deeper into the forest. 
Central Forest
The jungle is all you can see.

You can see a strange rock here.

>e
Eastern Forest

>e
Shadow Fang Lair

>w
Eastern Forest
 

You can see water (empty) here.

>w
Central Forest
The jungle is all you can see.

You can see a strange rock here.

>s
Southern Forest
Huge trees and bushes surround you as far as you can see.

* * *

>s
Camp
You are in a small clearing between four huge canopy trees. You notice you have built a fire pit, but the fire has burnt out leaving a mound of ash surrounded by rocks.

You can see a knife, a coil of rope, and a bottle (empty) here.

>s
Beach
You head south, weaving through the trees, watching the grassy terrain of the jungle slowly fade to dirt. Soon, the dirt is gone and you can see the ocean through the remainder of the trees. You burst through the gap out of  the foliage and into the light. The sand heats your toes and sends a warm surge throughout your body. The relaxing sun shines down onto the water, causing it to shimmer with brilliance.

You can see a boat here.

>n
Camp
You are in a small clearing between four huge canopy trees. You notice you have built a fire pit, but the fire has burnt out leaving a mound of ash surrounded by rocks.

You can see a knife, a coil of rope, and a bottle (empty) here.

>s
Beach
You head south, weaving through the trees, watching the grassy terrain of the jungle slowly fade to dirt. Soon, the dirt is gone and you can see the ocean through the remainder of the trees. You burst through the gap out of  the foliage and into the light. The sand heats your toes and sends a warm surge throughout your body. The relaxing sun shines down onto the water, causing it to shimmer with brilliance.

You can see water (empty) and a boat here.

>n
Camp
You are in a small clearing between four huge canopy trees. You notice you have built a fire pit, but the fire has burnt out leaving a mound of ash surrounded by rocks.

You can see a knife, a coil of rope, and a bottle (empty) here.

>w
You can't go that way.

I beg your pardon?

* * *

>e
Eastern Forest

>take water
You don't have anything to fill with water.

>w
Central Forest
The jungle is all you can see.

You can see a strange rock here.

* * *

>s
Camp
You are in a small clearing between four huge canopy trees. You notice you have built a fire pit, but the fire has burnt out leaving a mound of ash surrounded by rocks.

You can see a knife, a coil of rope, and a bottle (empty) here.

>take bottle
You pick up the empty bottle and put it into your backpack.

>n
Southern Forest
Huge trees and bushes surround you as far as you can see.

* * *

>n
You journey deeper into the forest. 
Central Forest
The jungle is all you can see.

You can see a strange rock here.

>e
Eastern Forest
 

You can see water (empty) here.

>take water
You fill the bottle with cool, fresh, drinking water from the river.

Taken.

>n
You can't go that way.

>n
You can't go that way.

I beg your pardon?

>nw
You can't go that way.

>w
Central Forest
The jungle is all you can see.

You can see a strange rock here.

>n
Northern Forest
You walk out of the trees and into a small clearing. There is a large rock here with strange engravings on it.

* * *

>e
(first opening the golden door)
It seems to be locked.

>open door
It seems to be locked.

>unlock door
(with the backpack)
That doesn't seem to fit the lock.

* * *

>s
Beach
You head south, weaving through the trees, watching the grassy terrain of the jungle slowly fade to dirt. Soon, the dirt is gone and you can see the ocean through the remainder of the trees. You burst through the gap out of  the foliage and into the light. The sand heats your toes and sends a warm surge throughout your body. The relaxing sun shines down onto the water, causing it to shimmer with brilliance.

You can see a boat and water (empty) here.

>take the boat
Taken.

>put boat in water
That can't contain things.

* * *

>s
Beach
You head south, weaving through the trees, watching the grassy terrain of the jungle slowly fade to dirt. Soon, the dirt is gone and you can see the ocean through the remainder of the trees. You burst through the gap out of  the foliage and into the light. The sand heats your toes and sends a warm surge throughout your body. The relaxing sun shines down onto the water, causing it to shimmer with brilliance.

You can see a boat and water (empty) here.

>put boat in water
(first taking the boat)

You put the boat into water.

* * *

>stop
That's not a verb I recognise.

>n
Southern Forest
Huge trees and bushes surround you as far as you can see.

* * *

>n
Mountain Base

>n
Mountain Summit Shrine
You walk up the long winding mountain path until you reach the summit. There is a shrine here for one of the island's gods. A man in shiny golden robes and a silver helmet is examining a massive golden door guarded by two black statues. The air coming from the door feels magical, almost like a divine being is on the other side.

He is muttering to himself, "Stupid door, why won't you open? The Shaman said to press the tiles so I pressed the tiles. You haven't been opened for hundreds of years! How are we supposed to commence all of our ceremonial rituals if we can't get into the shrine room!" The man hears your footsteps and turns around red and irritated.

"I am Chief Radzen, leader of the Geracian tribe and this is my land. Who are you and what is your purpose for coming to me?" he says.

You explain your situation to the Chief while he nods understandingly.

"Mmmhmmm… I see… Well, you need to find a way to get home don't you? We could help you, but first you need to prove you are worthy of our assistance and that you aren't just someone from an enemy tribe trying to invade us. Hmmmm… there is a magical beast on the other side of the river to the east of our village. It has been terrorizing my people, eating our livestock and trampling our crops. Find the beast and kill him. Then come talk to me. I景漠牵挠牥浥湯慩'll be in my hut; thinking of ways to open that stupid door…re w"

The Chief then walks briskly past you and dissapears down the mountain path.

You can see a golden door and a Chief here.