You wake up tired and groggy in the middle of a forest. You sleepily scan your surroundings and notice that they are unfamiliar and you have no idea how you got here. You try hard to remember how you got here, but you just can't seem to find the memory. In fact, you can't find any of your memories…

You snatch your backpack up off the ground, sling it over your shoulders, and start your quest to explore the island in hope of discovering who you are, how you got here, and how you're going to get home.

(hint - Press L to examine your surroundings again. Items, objects, or scenery may have magically appeared while you have been observing the room.)

(hint - Say "talk to" instead of asking)

(hint - Exits located in top left corner)

Escape From Paradise
Can you find your way back home? by Nik Hager
Release 1 / Serial number 131018 / Inform 7 build 6G60 (I6/v6.32 lib 6/12N) SD

Camp
The camp is set up in a small clearing between four huge canopy trees for shade and shelter from rain. You notice there is a fire pit in the middle that you must have build before, but the fire has burnt out leaving a mound of ash surrounded by charred rocks.

You can see a tent, a knife, a coil of rope, and a bottle (empty) here.

>x tent
A normal camping tent. It is made out of a material that is strong, yet thin.

[Your score has just gone up by one point.]

>x knife
A normal metal knife for cutting or stabbing things. You are unable to see your reflection in the blade as it is small and distorted.

[Your score has just gone up by two points.]

>n
Southern Forest
All you can see in every direction is the forest. The huge trees blocking out the light from the sun, the brush and bushes covering the forest floor, and the sound of small animals scurrying about around you, cracking the leaves as they run. You can see your camp is to the south.

>e
You can't go that way.

>n
You journey deeper into the forest.
 
Central Forest
All you can see in every direction is the forest. The huge trees blocking out the light from the sun, the brush and bushes covering the forest floor, and the sound of small animals scurrying about around you, cracking the leaves as they run. There is a mountain to the north and your camp is to the south.

>s
Southern Forest
All you can see in every direction is the forest. The huge trees blocking out the light from the sun, the brush and bushes covering the forest floor, and the sound of small animals scurrying about around you, cracking the leaves as they run. You can see your camp is to the south.

>s
Camp
The camp is set up in a small clearing between four huge canopy trees for shade and shelter from rain. You notice there is a fire pit in the middle that you must have build before, but the fire has burnt out leaving a mound of ash surrounded by charred rocks.

You can see a tent, a knife, a coil of rope, and a bottle (empty) here.

>take bottle
You pick up the empty bottle and put it into your backpack.

>x bottle
An empty plastic bottle. You could fill it up with clean water if you have the need for something to drink.

[Your score has just gone up by one point.]

>n
Southern Forest
All you can see in every direction is the forest. The huge trees blocking out the light from the sun, the brush and bushes covering the forest floor, and the sound of small animals scurrying about around you, cracking the leaves as they run. You can see your camp is to the south.

>n
You journey deeper into the forest.
 
Central Forest
All you can see in every direction is the forest. The huge trees blocking out the light from the sun, the brush and bushes covering the forest floor, and the sound of small animals scurrying about around you, cracking the leaves as they run. There is a mountain to the north and your camp is to the south.

>e
Eastern Forest
All you can see in every direction is the forest. The huge trees blocking out the light from the sun, the brush and bushes covering the forest floor, and the sound of small animals scurrying about around you, cracking the leaves as they run.

>fill bottle
You dip your bottle into the stream and fill it with sparkling pure water.

>e
You wouldn't want to get lost. Better stay on this side of the river for now.

>w
Central Forest
All you can see in every direction is the forest. The huge trees blocking out the light from the sun, the brush and bushes covering the forest floor, and the sound of small animals scurrying about around you, cracking the leaves as they run. There is a mountain to the north and your camp is to the south.

>n
You journey deeper into the forest.
 
Northern Forest
You walk out of the trees and into a small clearing. All you can see in every direction is the forest. You hear the sound of small animals scurrying about around you, cracking the leaves as they run. A narrow beam of light shines through a gap in the forest canopy, illuminating a large rock here with strange engravings on it.

You can see a strange rock here.

>n
Mountain Base
The trees lead up to a stone staircase lined by statues of dragons and warriors. The staircase leads up to the top of the mountain.

>n
Mountain Summit Shrine
You walk up the long winding mountain path until you reach the summit. There is a shrine here for one of the island's gods. A man in shiny golden robes and a silver helmet is examining a massive golden door guarded by two black statues. The air coming from the door feels magical, almost like a divine being is on the other side.

He is muttering to himself, "Stupid door, why won't you open? The Shaman said to rub the statues so I rubbed the statues and nothing happened. This stupid door hasn't been opened for hundreds of years! How are we supposed to commence all of our ceremonial rituals if we can't get into the shrine room!" 

You can see a Chief here.

>talk to chief
The man hears your footsteps and turns around red and irritated.

"I am Chief Radzen, leader of the Geracian tribe and this is my land. Who are you and what is your purpose for coming to me?" he says.

You explain your situation to the Chief while he nods understandingly.

"Mmmhmmm… I see… Well, you need to find a way to get home dontand't you? We could help you, but first you need to prove you are worthy of our assistance and that you aren't just someone from an enemy tribe trying to invade us. Hmmmm… there is a magical beast on the other side of the river to the east of our village. It has been terrorizing my people, eating our livestock and trampling our crops. Find the beast and kill him. Then come talk to me. I'll be in my hut; thinking of ways to open that stupid door…re"

The Chief then walks briskly past you and dissapears down the mountain path.

>s
Mountain Base
The trees lead up to a stone staircase lined by statues of dragons and warriors. The staircase leads up to the top of the mountain.

>s
Northern Forest
You walk out of the trees and into a small clearing. All you can see in every direction is the forest. You hear the sound of small animals scurrying about around you, cracking the leaves as they run. A narrow beam of light shines through a gap in the forest canopy, illuminating a large rock here with strange engravings on it.

You can see a strange rock here.

>s
Central Forest
All you can see in every direction is the forest. The huge trees blocking out the light from the sun, the brush and bushes covering the forest floor, and the sound of small animals scurrying about around you, cracking the leaves as they run. There is a mountain to the north and your camp is to the south.

>e
Eastern Forest
All you can see in every direction is the forest. The huge trees blocking out the light from the sun, the brush and bushes covering the forest floor, and the sound of small animals scurrying about around you, cracking the leaves as they run.

>e
Lair
You wade through the cold river water and reach a small clearing enclosed by towering walls of stone on every side. The shadow fang lays curled up against the stone. It looks weak and tired, like it could use some help.Its lair is littered with skulls of the mystical beast's prey and smells of… flowers? Well that isn't very intimidating is it?

You can see a shadow fang here.

>give water to shadow fang
(first taking the water)
You give the shadow fang some of your water and it gradually starts to feel better. It is extremely grateful for your act of kindness and decides to follow you around, accepting you as its master.

>w
Eastern Forest
All you can see in every direction is the forest. The huge trees blocking out the light from the sun, the brush and bushes covering the forest floor, and the sound of small animals scurrying about around you, cracking the leaves as they run. The shadow fang follows you closely.

>w
Central Forest
All you can see in every direction is the forest. The huge trees blocking out the light from the sun, the brush and bushes covering the forest floor, and the sound of small animals scurrying about around you, cracking the leaves as they run. The shadow fang follows you closely. There is a mountain to the north and your camp is to the south.

>w
Western Forest
A section of the forest lacking trees and foliage. There is a village to your west, the openning back to the forest is to the east, and both the north and south exits look too densely populated with trees to navigate in. The shadow fang follows you closely.

>w
Village
A small village in the middle of the forest. The small huts that make up the village are aligned in a circle around the center of the village. There is a slightly larger and nicer hut to the south, most likely belonging to their leader, and a strange voodoo-like hut to the north, seemingly belonging to a shaman or mystic. The shadow fang follows you closely.

>s
Chief's Hut
The Chief's hut is warm and smells like scented candles. The Chief's hunting and war trophies decorate the room and give a feeling of pride and victory to the room. The shadow fang comfortably curls up into a ball on the floor.

You can see a Chief and a Young Boy here.

>talk to chief
"Get that demon out of here! I must go see the Shaman." The Chief rushes out of his hut and breaks across the village.

>n
Village
A small village in the middle of the forest. The small huts that make up the village are aligned in a circle around the center of the village. There is a slightly larger and nicer hut to the south, most likely belonging to their leader, and a strange voodoo-like hut to the north, seemingly belonging to a shaman or mystic. The shadow fang follows you closely.

>n
Shaman's Hut
The hut of the island Shaman. The walls are lined with strange, voodoo like objects and the air smells of rotting fruit and dead weasels, whatever that smells like. You walk into the Shaman's hut with the Shadow fang following closely behind you. The shadow fang lays down on the floor across your feet and puts its head down on its paws.

You can see a Chief and a Shaman here.

>talk to chief
The Chief turns around and is startled by the beast.

"Why would you bring that thing here! It has been terrorizing my people for hundreds of years!" he shouts, "BEGONE DEMON!!!"

"Don't worry," you reply. "He's not going to hurt anyone. He was thirsty and I helped him. He was only trying to get food to survive when he destroyed your crops."

"I see. Well in that case, you have solved the greatest problem of my people. You shall be known for all time as the Bwana Wa Mnyama Kivuli, Master of the Shadow Beast. Your name shall be worshipped for centuries to come.

Now that you have proved yourself you must make your decision. Do you still wish to return home?"

>yes
"All right. The decision has been made."

The Chief speaks to the Shaman in a language you cannot understand and the Shaman nods. The Shaman walks over and puts his hand on your forehead.

"Kutuma mtu huyu ambayo amekuja. Tafadhali bwana Tryn basi hii kufanyika. Kwa nguvu imewekeza katika mimi na miungu ya nchi hii. Mimi jitihada kuaga kwako na kurudi kwako nyumbani, kwa mkono wangu kichawi."You close your eyes and say, "I wish I was back home!" he chants.

You feel a strong whipping wind swirl around you and the shadow fang backs away. You feel yourself lifting into the air and slowly losing consciousness before you black out completely.

When you shake off the dizziness and open your eyes, you are laying on your bed at home staring up at the ceiling. All your memories are coming back now. You remember that your name is James Palazo, you are 24 years old, you live in Boston Massachusetts, and seeing as the time is 4:00 PM, you're late for the Red Sox game!

    *** You have won ***

In that game you scored 14 out of a possible 53, in 34 turns, earning you the rank of Student Adventurer.

Would you like to RESTART, RESTORE a saved game, QUIT, or UNDO the last command?

* * *

>n
Southern Forest
All you can see in every direction is the forest. The huge trees blocking out the light from the sun, the brush and bushes covering the forest floor, and the sound of small animals scurrying about around you, cracking the leaves as they run. You can see your camp is to the south.

* * *

>n
You journey deeper into the forest.
 
Central Forest
All you can see in every direction is the forest. The huge trees blocking out the light from the sun, the brush and bushes covering the forest floor, and the sound of small animals scurrying about around you, cracking the leaves as they run. There is a mountain to the north and your camp is to the south.

>w
Western Forest
A section of the forest lacking trees and foliage. There is a village to your west, the openning back to the forest is to the east, and both the north and south exits look too densely populated with trees to navigate in.

>w
Village
A small village in the middle of the forest. The small huts that make up the village are aligned in a circle around the center of the village. There is a slightly larger and nicer hut to the south, most likely belonging to their leader, and a strange voodoo-like hut to the north, seemingly belonging to a shaman or mystic.

>s
Chief's Hut
The Chief's hut is warm and smells like scented candles. The Chief's hunting and war trophies decorate the room and give a feeling of pride and victory to the room.

You can see a young boy here.

>talk to boy
You walk up to the young boy and say hi.

"Hey!" he replies. "I've never seen you here before. You must be looking for my dad. He's the Chief of our tribe. I guess that makes him the Chief of the island too "cause we're the only tribe left. Ha! Anyways, he went up to the Mountain Shrine. He heard some people talking about a lost portion of the shrine that has been forgotten for hundreds of years so he went up there to look for it. You should go talk to him, just walk up the mountain north of the forest. It's not that far from here."

"Thanks," you reply.

"No problem," says the Chief's son, "Good luck finding him!"

As you walk out of the hut you realize that the boy spoke in a foreign language you are sure you've never heard before, but strangely it makes sense to you.

Village
A small village in the middle of the forest. The small huts that make up the village are aligned in a circle around the center of the village. There is a slightly larger and nicer hut to the south, most likely belonging to their leader, and a strange voodoo-like hut to the north, seemingly belonging to a shaman or mystic.

>talk to boy
You can't see any such thing.

>s
Chief's Hut
The Chief's hut is warm and smells like scented candles. The Chief's hunting and war trophies decorate the room and give a feeling of pride and victory to the room.

You can see a young boy here.

>talk to boy
You walk up to the young boy and say hi.

"Hey!" he replies. "You must be looking for my dad. He's the Chief of our tribe. I guess that makes him the Chief of the island too "cause we're the only tribe left. Ha! Anyways, he went up to the Mountain Shrine. He heard some people talking about a lost portion of the shrine that has been forgotten for hundreds of years so he went up there to look for it. You should go talk to him, just walk up the mountain north of the forest. It's not that far from here."

"Thanks," you reply.

"No problem," says the Chief's son, "Good luck finding him!"

You walk out of the hut.

Village
A small village in the middle of the forest. The small huts that make up the village are aligned in a circle around the center of the village. There is a slightly larger and nicer hut to the south, most likely belonging to their leader, and a strange voodoo-like hut to the north, seemingly belonging to a shaman or mystic.

>s
Chief's Hut
The Chief's hut is warm and smells like scented candles. The Chief's hunting and war trophies decorate the room and give a feeling of pride and victory to the room.

You can see a young boy here.

>s
You can't go that way.

>n
Village
A small village in the middle of the forest. The small huts that make up the village are aligned in a circle around the center of the village. There is a slightly larger and nicer hut to the south, most likely belonging to their leader, and a strange voodoo-like hut to the north, seemingly belonging to a shaman or mystic.

>e
Western Forest
A section of the forest lacking trees and foliage. There is a village to your west, the openning back to the forest is to the east, and both the north and south exits look too densely populated with trees to navigate in.

>e
Central Forest
All you can see in every direction is the forest. The huge trees blocking out the light from the sun, the brush and bushes covering the forest floor, and the sound of small animals scurrying about around you, cracking the leaves as they run. There is a mountain to the north and your camp is to the south.

>s
Southern Forest
All you can see in every direction is the forest. The huge trees blocking out the light from the sun, the brush and bushes covering the forest floor, and the sound of small animals scurrying about around you, cracking the leaves as they run. You can see your camp is to the south.

* * *

>s
Camp
The camp is set up in a small clearing between four huge canopy trees for shade and shelter from rain. You notice there is a fire pit in the middle that you must have build before, but the fire has burnt out leaving a mound of ash surrounded by charred rocks.

You can see a tent, a knife, a coil of rope, and a bottle (empty) here.

>s
Beach
You head south, weaving through the trees, watching the grassy terrain of the jungle slowly fade to dirt. Soon, the dirt is gone and you can see the ocean through the remainder of the trees. You burst through the gap out of  the foliage and into the light. The sand heats your toes and sends a warm surge throughout your body. The relaxing sun shines down onto the water, causing it to shimmer with brilliance.

>x ocean
The ocean is empty.

[Your score has just gone up by one point.]

* * *

>s
Chief's Hut
The Chief's hut is warm and smells like scented candles. The Chief's hunting and war trophies decorate the room and give a feeling of pride and victory to the room.

You can see a young boy here.

>talk to young boy
You walk up to the young boy and say hi.

"Hey!" he replies. "Looking for dad? He's the Chief. He's super cool. I guess that makes him the Chief of the island too "cause we're the only tribe left.

He went up to the top of the mountain cuz he heard some people talking about a lost temple that's been gone for a long time so he went up there to look for it. You should go talk to him, just go north of the forest. He's up the mountain."

"Thanks," you reply.

"You're welcome," says the Chief's son, "Good luck!"

You walk out of the hut.

Village
A small village in the middle of the forest. The small huts that make up the village are aligned in a circle around the center of the village. There is a slightly larger and nicer hut to the south, most likely belonging to their leader, and a strange voodoo-like hut to the north, seemingly belonging to a shaman or mystic.

>e
Western Forest
A section of the forest lacking trees and foliage. There is a village to your west, the openning back to the forest is to the east, and both the north and south exits look too densely populated with trees to navigate in.

* * *

>e
Central Forest
All you can see in every direction is the forest. The huge trees blocking out the light from the sun, the brush and bushes covering the forest floor, and the sound of small animals scurrying about around you, cracking the leaves as they run. There is a mountain to the north and your camp is to the south.

>n
You journey deeper into the forest.
 
Northern Forest
You walk out of the trees and into a small clearing. All you can see in every direction is the forest. You hear the sound of small animals scurrying about around you, cracking the leaves as they run. A narrow beam of light shines through a gap in the forest canopy, illuminating a large rock here with strange engravings on it.

You can see a strange rock here.

* * *

>talk to chief
The man hears your footsteps and turns around red and irritated.

"I am Chief Radzen, leader of the Geracian tribe and this is my land. Who are you and what is your purpose for coming to me?" he says.

You explain your situation to the Chief, puzzled that you understand each other, while he nods understandingly.

"Mmmhmmm… I see… Well, you need to find a way to get home don't you? We could help you, but first you need to prove you are worthy of our assistance and that you aren't just someone from an enemy tribe trying to invade us. Hmmmm… there is a magical beast on the other side of the river to the east of our village. It has been terrorizing my people, eating our livestock and trampling our crops. Find the beast and kill him. Then come talk to me. I'll be in my hut; thinking of ways to open that stupid door…"

The Chief then walks briskly past you and dissapears down the mountain path.

* * *

>x sun
The trees of the forest block out the sun.

>s
Beach
You head south, weaving through the trees, watching the grassy terrain of the jungle slowly fade to dirt. Soon, the dirt is gone and you can see the ocean through the remainder of the trees. You burst through the gap out of  the foliage and into the light. The sand heats your toes and sends a warm surge throughout your body. The relaxing sun shines down onto the water, causing it to shimmer with brilliance.

>x sun
The sun shines bright in the sky. You can't examine it closely though. You wouldn't want to hurt your eyes.

>x sun
The sun shines bright in the sky. You can't examine it closely though. You wouldn't want to hurt your eyes.

>l
Beach
You head south, weaving through the trees, watching the grassy terrain of the jungle slowly fade to dirt. Soon, the dirt is gone and you can see the ocean through the remainder of the trees. You burst through the gap out of  the foliage and into the light. The sand heats your toes and sends a warm surge throughout your body. The relaxing sun shines down onto the water, causing it to shimmer with brilliance.

>x sun
The sun shines bright in the sky. You can't examine it closely though. You wouldn't want to hurt your eyes.

>n
Camp
The camp is set up in a small clearing between four huge canopy trees for shade and shelter from rain. You notice there is a fire pit in the middle that you must have build before, but the fire has burnt out leaving a mound of ash surrounded by charred rocks.

You can see a tent, a knife, a coil of rope, and a bottle (empty) here.

>n
Southern Forest
All you can see in every direction is the forest. The huge trees blocking out the light from the sun, the brush and bushes covering the forest floor, and the sound of small animals scurrying about around you, cracking the leaves as they run. You can see your camp is to the south.

>x sun
The trees of the forest block out the sun.

>n
You journey deeper into the forest.
 
Central Forest
All you can see in every direction is the forest. The huge trees blocking out the light from the sun, the brush and bushes covering the forest floor, and the sound of small animals scurrying about around you, cracking the leaves as they run. There is a mountain to the north and your camp is to the south.

>x sun
The trees of the forest block out the sun.

>n
You journey deeper into the forest.
 
Northern Forest
You walk out of the trees and into a small clearing. All you can see in every direction is the forest. You hear the sound of small animals scurrying about around you, cracking the leaves as they run. A narrow beam of light shines through a gap in the forest canopy, illuminating a large rock here with strange engravings on it.

You can see a strange rock here.

>x sun
A beam of light shines down from the sky illuminating the strange rock. You can't examine it closely though. You wouldn't want to hurt your eyes.